accNumber,transactionType,amount,balance,date,time
3,withdraw,3,13677,22/04/24,11:40
3,deposit,3,13680,22/04/24,11:41
3,withdraw,3,13677,22/04/24,11:41
3,withdraw,363,13314,22/04/24,11:41
3,withdraw,235,13079,22/04/24,11:41
3,deposit,385,13464,22/04/24,15:38
3,withdraw,3000,10464,22/04/24,15:38
3,transfer,3000,7464,23/04/24,11:52
2,transfer,3000,3000,23/04/24,11:52
